F 10,10,10

C 0,50,50

NO xpm_assets/TECH_3B.xpm

SO xpm_assets/WOOD_1C.xpm

WE xpm_assets/TILE_1A.xpm

EA xpm_assets/TECH_4F.xpm

111111111111111111111111111111111111111111111111
10000000001                100000000000000000001
10000000001                100000000000000000001
10000000001                100000000000000000001
100000000011111111111111111100001111111110000001
111111000000000001111111110000000000000000000001
111111000000000001111111110000000000000000000001
111111000000000001111111110000000100000000000001
1111110000000000011111111100000001000011111111111
100000000000000001111111110000000100000000000001
100011111111100000111111111000000100000011111101
100000000000000000000000N00000000100000000000001
100000000011111111111111111111111100000000000001
100000000010000000000000000000000000000000000001
111111111010000100000000000000000000001111111111
100000000010000100000000000000000000000000000001
100000000010000111111111111111111110000000000001
100000000010000000000000000000000000000000000001
111111111111111111111111111111111111111111111111