F 255,5,65

C 255,123,123

NO ./xpm_assets/BRICK_6D.xpm

SO ./xpm_assets/HEDGE_1A.xpm

WE ./xpm_assets/LIGHT_1B.xpm

EA ./xpm_assets/PIPES_1A.xpm

11111111111                111111111111111111111
10000000001                100000000000000000001
10000000001                100000000000000000001
10000000001                100000000000000000001
10000000001111111111111111110000000000000000000111111
1111110000000000000000000000000000000000000000000000111111
     11111100000000000000000000000000000000000000000000001
     11111100000000000000000000000000000000000000000000001
1111110000000000000000000000000000000000000000011111111111
100000000000000000000000000000000000000000000001
100000000000000000000000000000000000000000000001
100000000000000000000000N00000000000000000000001
100000000000000000000000000000000000000000000001
100000000000000000000000000000000000000000000001
111111111000000000000000000000000000001111111111
        1000000000000000000000000000001
        1000000000000000000000000000001
        1000000000000000000000000000001
        1111111111111111111111111111111
