1111111111111111111111111111111
1000000000000000000000000000001
10000000000N0000000000000000001
1000000000000000000000000000001
10000000E000000W000000000000001
10000000000S0000000000000000001
1000000000000000000000000000001
1111111111111111111111111111111