F 10,10,10

C 0,150,50

NO ./path_to_the_north_texture

SO ./path_to_the_south_texture

WE ./path_to_the_west_texture

EA ./path_to_the_east_texture

111111111111111111111111111111111111111111111111
10000000001                100000000000000000001
10000000001                100000000000000000001
10000000001                100000000000000000001
100000000011111111111111111100001111111110000001
111111000000000001111111110000000000000000000001
111111000000000001111111110000000000000000000001
111111000000000001111111110000000000000000000001
1111110000000000011111111100000000000011111111111
100000000000000001111111110000000000000000000001
100011111111100000111111111000000000000011111101
100000000000000000000000N00000000000000000000001
100000000011111111111111111111111100000000000001
100000000000000000000000000000000000000000000001
111111111000000000000000000000000000001111111111
100000000000000000000000000000000000000000000001
100000000000000111111111111111111110000000000001
100000000000000000000000000000000000000000000001
111111111111111111111111111111111111111111111111