F 255,5,65
C 255,123,123

NO ./path_to_the_north_texture

SO ./path_to_the_south_texture

WE ./path_to_the_west_texture

EA ./path_to_the_east_texture

1111111111111111111111111111111111111111111111111111111111*
1000000000111111111111111111000000000000000000011111111111*
10000000001                1000000000000000000011111111111*
10000000001                1000000000000000000011111111111*
1000000000111111111111111111000000000000000000011111111111*
1111110000000000N00000000000000000000000000000000000111111*
1111 1111110000000000N000000000000000000000000000000000001*
1111 1111110000000000N000000000000000000000000000000000001*
11111100000N00000000X0000000000000000000000000011111111111*
10000000000N0000000000000000000000000000000000011111111111*
10000000000N0000000000000000000000000000000000011111111111*
10000000000N0000000000000000000000000000000000011111111111*
10000000000N0000000000000000000000000000000000011111111111*
10000000000N0000000000000000000000000000000000011111111111*
1111111110000000000000000000000000000011111111111111111111*
1111    10000000E000000W0000000000000011111111111111111111*
1111    10000000000S00000000000000000011111111111111111111*
1111111110000000000000000000000000000011111111111111111111*
1111111111111111111111111111111111111111111111111111111111*
