1111111111111111111111111111111
1001001
10E0001
1001001
1111111111111111111111111111111