111111111111111
100000000000001
100S001000000011111111
1000001000000000000001
1000000000000000000001
1000001200000000000001
1111111111111111111111