F 0,5,0

C 0,123,0
NO ./xpm_assets/BRICK_6D.xpm

SO ./xpm_assets/HEDGE_1A.xpm

WE ./xpm_assets/LIGHT_1B.xpm

EA ./xpm_assets/PIPES_1A.xpm

111111111111111
100000000000001
1000001000000011111111
1000E01000000000000001
1000000000000000000001
1000001000000000000011
1111111111111111111111