1111111111
1000001111
1000E00001
1000001111
1111111111