111111111111111
100000000000001
100S0010001
1000001000000000000001
1000000000000000000001
1000001200000000000001
1111111111111111111111