1111111111
1000001111
10000E0001
1000001111
1111111111