F 255,5,65

C 255,123,123

NO ./path_to_the_north_texture

SO ./path_to_the_south_texture

WE ./path_to_the_west_texture

EA ./path_to_the_east_texture

111111111111111
100000000000001
100S001000000011111111
1000001000000000000001
1000000000000000000001
1000001000000000000011
1111111111111111111111